NO    ./textures/no.xpm
SO ./textures/ea.xpm
WE ./textures/we.xpm
EA ./textures/so.xpm

F 220,100,087
C 225,30,0


        11111111111  11111111111111111
        111100000000000000000001111111
        101100000111000000000000100101
        100100000000000000000000111111
111111111011000001110000000000000    1
10000000001100000111011111111111111111
11110111111111011100000010001
1111011111111101110101001000111111111111111111111111111
1100000011010101110000001000000000000000000000000000001
1000000000000000110000001000111111111101111111111111111
10000000000000001101010010001        111
11000001110101011111011110N0111
11110111 1110101 101111010001
11111111 1111111 111111111111
