

NO    ./drawable/alian.xpm
SO ./drawable/saturn.xpm
WE ./drawable/sky.xpm
EA ./drawable/view.xpm

F    78, 65, 88
C    252, 220, 182

111111111
1000000011111111111111111111111111111111111111111111111111111111111111111111111111111111111
1N00000000020000000000000000000000000000000000200000000000000000000000000000000000000000001
1000000011111100011111111111111111111000000001111111111111111111111111111111111111111100001
1111110011111100011111111111111111111000000001111111111111111111111111111111111111111100001
     10011111100011111111111111111111000000001111111111111111111111111111111111111111100001
     10011111100000000000000000000000000000000000000000000000000000000000000000000000000001
     10011111100011111111111111111111111111111111111111111111111111111111111111111111111111
111111001111110001
100000001111110001
100002001111110001
120000000000000001
111111111111111111
