F 78, 65, 88
C 252, 220, 182

SO ./drawable/lake.xpm
WE ./drawable/field.xpm
EA ./drawable/island.xpm
NO    ./drawable/town.xpm

//11111111111111111111111111111111111111111111111111111111111111
//10000000000000000000000000000000000000000000000000000000000001
//1N000000000200000000000000000000000000000000000000000000000001
//10000000111111000111111111111111111110000000011111111111100001
//11111100111111000111111111111111111110000000011111111111100001
//     100111111000111111111111111111110000000011111111111100001
//     100111111000000000000000000000000000000000000000000000001
//     100111111000111111111111111110001111111111111111111111111
//11111100111111000111111111100000000000000001111111111111111111
//10000000111111000111111111100000000000000001111111111111111111
//10000200111111000111111111100000000000000001111111111111111111
//12000000000000000111111111100000000000000001111111111111111111
//11111111111111111111111111111111111111111111111111111111111111



11111111111111111111111111111111111111111111111111111111111111
10000000000000000001100000011000000000011000011100000000011111
12111011111110111100101100000000011100000011001100001110001111
10111011111110000000000111111111111111111111001100001000011111
10111010000011111111110000000000001111111001000000000000111111
10111000001010000000010111111111000000000100000100001111111111
10111111111010001111001000100001100111110011111111110111111111
10100000000011101100000010001001111110001000000000011111111111
10100110011100001111111111001111111000100111000000000000000001
10100110000001111110000001001111000000100011111100001110011111
10100111111110000000111101000000000100000000011100001110011111
10100001111110111011111111110000000000000001111111111110011111
10100010000110110010000000001000000111010000000000000000000001
10100000010000110100000000000000000000000001111111111100111111
10110011111111110111111111100011111000000000000000111100111111
10110011000000000121000000110001111111110011100000111100111111
10110011000111111010011100100001111111111111100000111100111111
10110011110111100010000000000011000000000000000000000000111111
10111000010111100011111111111111111111111111111111111100111111
10111000000111100011111111111100000011000000000000111100111111
10111111110000000011111111110000000000011111111100001111111111
10110000110111111111111111110011111111111111111111100111111111
10100010110011000000000001110000000000000000000000122222222211
1011111010201100011111110111111101110000110111110112222N222211
10000000110000000111111100000000011100000001110001122222222211
11111111111111111111111111111111111111111111111111111111111111